0 0 0 0 4 3 3 3 3 3 3 3 8 0 0 0 0 4 3 3 3 3 3 3 3 8 0 0 0 0 4 3 3 3 3 3 3 3 8 0 0 0 0 4 3 3 3 3 3 3 3 8 0 0 0 0 4 3 3 3 3 3 3 3 8 0 0 0 0
0 0 0 0 5 2 2 2 2 2 2 2 7 0 0 0 0 5 2 2 2 2 2 2 2 7 0 0 0 0 5 2 2 2 2 2 2 2 7 0 0 0 0 5 2 2 2 2 2 2 2 7 0 0 0 0 5 2 2 2 2 2 2 2 7 0 0 0 0
0 0 0 0 5 1 1 1 1 1 1 1 14 3 3 3 3 15 1 1 1 1 1 1 1 7 0 0 0 0 5 1 1 1 1 1 1 1 14 3 3 3 3 15 1 1 1 1 1 1 1 7 0 0 0 0 5 1 1 1 1 1 1 1 7 0 0 0 0
0 0 0 0 5 1 1 1 1 1 1 1 1 1 1 1 1 1 1 1 1 1 1 1 1 7 0 0 0 0 5 1 1 1 1 1 1 1 1 1 1 1 1 1 1 1 1 1 1 1 1 7 0 0 0 0 5 1 1 1 1 1 1 1 7 0 0 0 0
0 0 0 0 5 1 1 1 1 1 1 1 13 6 6 6 6 12 1 1 1 1 1 1 1 7 0 0 0 0 5 1 1 1 1 1 1 1 13 6 6 6 6 12 1 1 1 1 1 1 1 7 0 0 0 0 5 1 1 1 1 1 1 1 7 0 0 0 0
0 0 0 0 5 1 1 1 1 1 1 1 7 0 0 0 0 5 1 1 1 1 1 1 1 7 0 0 0 0 5 1 1 1 1 1 1 1 7 0 0 0 0 5 1 1 1 1 1 1 1 7 0 0 0 0 5 1 1 1 1 1 1 1 7 0 0 0 0
0 0 0 0 9 6 6 12 1 13 6 6 11 0 0 0 0 9 6 6 12 1 13 6 6 11 0 0 0 0 9 6 6 12 1 13 6 6 11 0 0 0 0 9 6 6 12 1 13 6 6 11 0 0 0 0 9 6 6 12 1 13 6 6 11 0 0 0 0
0 0 0 0 0 0 0 5 1 7 0 0 0 0 0 0 0 0 0 0 5 1 7 0 0 0 0 0 0 0 0 0 0 5 1 7 0 0 0 0 0 0 0 0 0 0 5 1 7 0 0 0 0 0 0 0 0 0 0 5 1 7 0 0 0 0 0 0 0
0 0 0 0 0 0 0 5 1 7 0 0 0 0 0 0 0 0 0 0 5 1 7 0 0 0 0 0 0 0 0 0 0 5 1 7 0 0 0 0 0 0 0 0 0 0 5 1 7 0 0 0 0 0 0 0 0 0 0 5 1 7 0 0 0 0 0 0 0
0 0 0 0 0 0 0 5 1 7 0 0 0 0 0 0 0 0 0 0 5 1 7 0 0 0 0 0 0 0 0 0 0 5 1 7 0 0 0 0 0 0 0 0 0 0 5 1 7 0 0 0 0 0 0 0 0 0 0 5 1 7 0 0 0 0 0 0 0
0 0 0 0 0 0 0 5 1 7 0 0 0 0 0 0 0 0 0 0 5 1 7 0 0 0 0 0 0 0 0 0 0 5 1 7 0 0 0 0 0 0 0 0 0 0 5 1 7 0 0 0 0 0 0 0 0 0 0 5 1 7 0 0 0 0 0 0 0
0 0 0 0 0 0 0 5 1 7 0 0 0 0 0 0 0 0 0 0 5 1 7 0 0 0 0 0 0 0 0 0 0 5 1 7 0 0 0 0 0 0 0 0 0 0 5 1 7 0 0 0 0 0 0 0 0 0 0 5 1 7 0 0 0 0 0 0 0
0 0 0 0 0 0 0 5 1 7 0 0 0 0 0 0 0 0 0 0 5 1 7 0 0 0 0 0 0 0 0 0 0 5 1 7 0 0 0 0 0 0 0 0 0 0 5 1 7 0 0 0 0 0 0 0 0 0 0 5 1 7 0 0 0 0 0 0 0
0 0 0 0 4 3 3 15 1 14 3 3 8 0 0 0 0 4 3 3 15 1 14 3 3 8 0 0 0 0 4 3 3 15 1 14 3 3 8 0 0 0 0 4 3 3 15 1 14 3 3 8 0 0 0 0 4 3 3 15 1 14 3 3 8 0 0 0 0
0 0 0 0 5 2 2 2 1 2 2 2 7 0 0 0 0 5 2 2 2 1 2 2 2 7 0 0 0 0 5 2 2 2 1 2 2 2 7 0 0 0 0 5 2 2 2 1 2 2 2 7 0 0 0 0 5 2 2 2 1 2 2 2 7 0 0 0 0
0 0 0 0 5 1 1 1 1 1 1 1 14 3 3 3 3 15 1 1 1 1 1 1 1 14 3 3 3 3 15 1 1 1 1 1 1 1 14 3 3 3 3 15 1 1 1 1 1 1 1 14 3 3 3 3 15 1 1 1 1 1 1 1 7 0 0 0 0
0 0 0 0 5 1 1 1 1 1 1 1 1 1 1 1 1 1 1 1 1 1 1 1 1 1 1 1 1 1 1 1 1 1 1 1 1 1 1 1 1 1 1 1 1 1 1 1 1 1 1 1 1 1 1 1 1 1 1 1 1 1 1 1 7 0 0 0 0
0 0 0 0 5 1 1 1 1 1 1 1 13 6 6 6 6 12 1 1 1 1 1 1 1 13 6 6 6 6 12 1 1 1 1 1 1 1 13 6 6 6 6 12 1 1 1 1 1 1 1 13 6 6 6 6 12 1 1 1 1 1 1 1 7 0 0 0 0
0 0 0 0 5 1 1 1 1 1 1 1 7 0 0 0 0 5 1 1 1 1 1 1 1 7 0 0 0 0 5 1 1 1 1 1 1 1 7 0 0 0 0 5 1 1 1 1 1 1 1 7 0 0 0 0 5 1 1 1 1 1 1 1 7 0 0 0 0
0 0 0 0 9 6 6 12 1 13 6 6 11 0 0 0 0 9 6 6 12 1 13 6 6 11 0 0 0 0 9 6 6 12 1 13 6 6 11 0 0 0 0 9 6 6 12 1 13 6 6 11 0 0 0 0 9 6 6 12 1 13 6 6 11 0 0 0 0
0 0 0 0 0 0 0 5 1 7 0 0 0 0 0 0 0 0 0 0 5 1 7 0 0 0 0 0 0 0 0 0 0 5 1 7 0 0 0 0 0 0 0 0 0 0 5 1 7 0 0 0 0 0 0 0 0 0 0 5 1 7 0 0 0 0 0 0 0
0 0 0 0 0 0 0 5 1 7 0 0 0 0 0 0 0 0 0 0 5 1 7 0 0 0 0 0 0 0 0 0 0 5 1 7 0 0 0 0 0 0 0 0 0 0 5 1 7 0 0 0 0 0 0 0 0 0 0 5 1 7 0 0 0 0 0 0 0
0 0 0 0 0 0 0 5 1 7 0 0 0 0 0 0 0 0 0 0 5 1 7 0 0 0 0 0 0 0 0 0 0 5 1 7 0 0 0 0 0 0 0 0 0 0 5 1 7 0 0 0 0 0 0 0 0 0 0 5 1 7 0 0 0 0 0 0 0
0 0 0 0 0 0 0 5 1 7 0 0 0 0 0 0 0 0 0 0 5 1 7 0 0 0 0 0 0 0 0 0 0 5 1 7 0 0 0 0 0 0 0 0 0 0 5 1 7 0 0 0 0 0 0 0 0 0 0 5 1 7 0 0 0 0 0 0 0
0 0 0 0 0 0 0 5 1 7 0 0 0 0 0 0 0 0 0 0 5 1 7 0 0 0 0 0 0 0 0 0 0 5 1 7 0 0 0 0 0 0 0 0 0 0 5 1 7 0 0 0 0 0 0 0 0 0 0 5 1 7 0 0 0 0 0 0 0
0 0 0 0 0 0 0 5 1 7 0 0 0 0 0 0 0 0 0 0 5 1 7 0 0 0 0 0 0 0 0 0 0 5 1 7 0 0 0 0 0 0 0 0 0 0 5 1 7 0 0 0 0 0 0 0 0 0 0 5 1 7 0 0 0 0 0 0 0
0 0 0 0 4 3 3 15 1 14 3 3 8 0 0 0 0 4 3 3 15 1 14 3 3 8 0 0 0 0 4 3 3 15 1 14 3 3 8 0 0 0 0 4 3 3 15 1 14 3 3 8 0 0 0 0 4 3 3 15 1 14 3 3 8 0 0 0 0
0 0 0 0 5 2 2 2 1 2 2 2 7 0 0 0 0 5 2 2 2 1 2 2 2 7 0 0 0 0 5 2 2 2 1 2 2 2 7 0 0 0 0 5 2 2 2 1 2 2 2 7 0 0 0 0 5 2 2 2 1 2 2 2 7 0 0 0 0
0 0 0 0 5 1 1 1 1 1 1 1 14 3 3 3 3 15 1 1 1 1 1 1 1 14 3 3 3 3 15 1 1 1 1 1 1 1 14 3 3 3 3 15 1 1 1 1 1 1 1 7 0 0 0 0 5 1 1 1 1 1 1 1 7 0 0 0 0
0 0 0 0 5 1 1 1 1 1 1 1 1 1 1 1 1 1 1 1 1 1 1 1 1 1 1 1 1 1 1 1 1 1 1 1 1 1 1 1 1 1 1 1 1 1 1 1 1 1 1 7 0 0 0 0 5 1 1 1 1 1 1 1 7 0 0 0 0
0 0 0 0 5 1 1 1 1 1 1 1 13 6 6 6 6 12 1 1 1 1 1 1 1 13 6 6 6 6 12 1 1 1 1 1 1 1 13 6 6 6 6 12 1 1 1 1 1 1 1 7 0 0 0 0 5 1 1 1 1 1 1 1 7 0 0 0 0
0 0 0 0 5 1 1 1 1 1 1 1 7 0 0 0 0 5 1 1 1 1 1 1 1 7 0 0 0 0 5 1 1 1 1 1 1 1 7 0 0 0 0 5 1 1 1 1 1 1 1 7 0 0 0 0 5 1 1 1 1 1 1 1 7 0 0 0 0
0 0 0 0 9 6 6 12 1 13 6 6 11 0 0 0 0 9 6 6 12 1 13 6 6 11 0 0 0 0 9 6 6 12 1 13 6 6 11 0 0 0 0 9 6 6 12 1 13 6 6 11 0 0 0 0 9 6 6 12 1 13 6 6 11 0 0 0 0
0 0 0 0 0 0 0 5 1 7 0 0 0 0 0 0 0 0 0 0 5 1 7 0 0 0 0 0 0 0 0 0 0 5 1 7 0 0 0 0 0 0 0 0 0 0 5 1 7 0 0 0 0 0 0 0 0 0 0 5 1 7 0 0 0 0 0 0 0
0 0 0 0 0 0 0 5 1 7 0 0 0 0 0 0 0 0 0 0 5 1 7 0 0 0 0 0 0 0 0 0 0 5 1 7 0 0 0 0 0 0 0 0 0 0 5 1 7 0 0 0 0 0 0 0 0 0 0 5 1 7 0 0 0 0 0 0 0
0 0 0 0 0 0 0 5 1 7 0 0 0 0 0 0 0 0 0 0 5 1 7 0 0 0 0 0 0 0 0 0 0 5 1 7 0 0 0 0 0 0 0 0 0 0 5 1 7 0 0 0 0 0 0 0 0 0 0 5 1 7 0 0 0 0 0 0 0
0 0 0 0 0 0 0 5 1 7 0 0 0 0 0 0 0 0 0 0 5 1 7 0 0 0 0 0 0 0 0 0 0 5 1 7 0 0 0 0 0 0 0 0 0 0 5 1 7 0 0 0 0 0 0 0 0 0 0 5 1 7 0 0 0 0 0 0 0
0 0 0 0 0 0 0 5 1 7 0 0 0 0 0 0 0 0 0 0 5 1 7 0 0 0 0 0 0 0 0 0 0 5 1 7 0 0 0 0 0 0 0 0 0 0 5 1 7 0 0 0 0 0 0 0 0 0 0 5 1 7 0 0 0 0 0 0 0
0 0 0 0 0 0 0 5 1 7 0 0 0 0 0 0 0 0 0 0 5 1 7 0 0 0 0 0 0 0 0 0 0 5 1 7 0 0 0 0 0 0 0 0 0 0 5 1 7 0 0 0 0 0 0 0 0 0 0 5 1 7 0 0 0 0 0 0 0
0 0 0 0 4 3 3 15 1 14 3 3 8 0 0 0 0 4 3 3 15 1 14 3 3 8 0 0 0 0 4 3 3 15 1 14 3 3 8 0 0 0 0 4 3 3 15 1 14 3 3 8 0 0 0 0 4 3 3 15 1 14 3 3 8 0 0 0 0
0 0 0 0 5 2 2 2 1 2 2 2 7 0 0 0 0 5 2 2 2 1 2 2 2 7 0 0 0 0 5 2 2 2 1 2 2 2 7 0 0 0 0 5 2 2 2 1 2 2 2 7 0 0 0 0 5 2 2 2 1 2 2 2 7 0 0 0 0
0 0 0 0 5 1 1 1 1 1 1 1 14 3 3 3 3 15 1 1 1 1 1 1 1 14 3 3 3 3 15 1 1 1 1 1 1 1 14 3 3 3 3 15 1 1 1 1 1 1 1 14 3 3 3 3 15 1 1 1 1 1 1 1 7 0 0 0 0
0 0 0 0 5 1 1 1 1 1 1 1 1 1 1 1 1 1 1 1 1 1 1 1 1 1 1 1 1 1 1 1 1 1 1 1 1 1 1 1 1 1 1 1 1 1 1 1 1 1 1 1 1 1 1 1 1 1 1 1 1 1 1 1 7 0 0 0 0
0 0 0 0 5 1 1 1 1 1 1 1 13 6 6 6 6 12 1 1 1 1 1 1 1 13 6 6 6 6 12 1 1 1 1 1 1 1 13 6 6 6 6 12 1 1 1 1 1 1 1 13 6 6 6 6 12 1 1 1 1 1 1 1 7 0 0 0 0
0 0 0 0 5 1 1 1 1 1 1 1 7 0 0 0 0 5 1 1 1 1 1 1 1 7 0 0 0 0 5 1 1 1 1 1 1 1 7 0 0 0 0 5 1 1 1 1 1 1 1 7 0 0 0 0 5 1 1 1 1 1 1 1 7 0 0 0 0
0 0 0 0 9 6 6 12 1 13 6 6 11 0 0 0 0 9 6 6 12 1 13 6 6 11 0 0 0 0 9 6 6 12 1 13 6 6 11 0 0 0 0 9 6 6 12 1 13 6 6 11 0 0 0 0 9 6 6 12 1 13 6 6 11 0 0 0 0
0 0 0 0 0 0 0 5 1 7 0 0 0 0 0 0 0 0 0 0 5 1 7 0 0 0 0 0 0 0 0 0 0 5 1 7 0 0 0 0 0 0 0 0 0 0 5 1 7 0 0 0 0 0 0 0 0 0 0 5 1 7 0 0 0 0 0 0 0
0 0 0 0 0 0 0 5 1 7 0 0 0 0 0 0 0 0 0 0 5 1 7 0 0 0 0 0 0 0 0 0 0 5 1 7 0 0 0 0 0 0 0 0 0 0 5 1 7 0 0 0 0 0 0 0 0 0 0 5 1 7 0 0 0 0 0 0 0
0 0 0 0 0 0 0 5 1 7 0 0 0 0 0 0 0 0 0 0 5 1 7 0 0 0 0 0 0 0 0 0 0 5 1 7 0 0 0 0 0 0 0 0 0 0 5 1 7 0 0 0 0 0 0 0 0 0 0 5 1 7 0 0 0 0 0 0 0
0 0 0 0 0 0 0 5 1 7 0 0 0 0 0 0 0 0 0 0 5 1 7 0 0 0 0 0 0 0 0 0 0 5 1 7 0 0 0 0 0 0 0 0 0 0 5 1 7 0 0 0 0 0 0 0 0 0 0 5 1 7 0 0 0 0 0 0 0
0 0 0 0 0 0 0 5 1 7 0 0 0 0 0 0 0 0 0 0 5 1 7 0 0 0 0 0 0 0 0 0 0 5 1 7 0 0 0 0 0 0 0 0 0 0 5 1 7 0 0 0 0 0 0 0 0 0 0 5 1 7 0 0 0 0 0 0 0
0 0 0 0 0 0 0 5 1 7 0 0 0 0 0 0 0 0 0 0 5 1 7 0 0 0 0 0 0 0 0 0 0 5 1 7 0 0 0 0 0 0 0 0 0 0 5 1 7 0 0 0 0 0 0 0 0 0 0 5 1 7 0 0 0 0 0 0 0
0 0 0 0 4 3 3 15 1 14 3 3 8 0 0 0 0 4 3 3 15 1 14 3 3 8 0 0 0 0 4 3 3 15 1 14 3 3 8 0 0 0 0 4 3 3 15 1 14 3 3 8 0 0 0 0 4 3 3 15 1 14 3 3 8 0 0 0 0
0 0 0 0 5 2 2 2 1 2 2 2 7 0 0 0 0 5 2 2 2 1 2 2 2 7 0 0 0 0 5 2 2 2 1 2 2 2 7 0 0 0 0 5 2 2 2 1 2 2 2 7 0 0 0 0 5 2 2 2 1 2 2 2 7 0 0 0 0
0 0 0 0 5 1 1 1 1 1 1 1 14 3 3 3 3 15 1 1 1 1 1 1 1 7 3 3 3 3 15 1 1 1 1 1 1 1 14 3 3 3 3 15 1 1 1 1 1 1 1 7 0 0 0 0 5 1 1 1 1 1 1 1 7 0 0 0 0
0 0 0 0 5 1 1 1 1 1 1 1 1 1 1 1 1 1 1 1 1 1 1 1 1 1 1 1 1 1 1 1 1 1 1 1 1 1 1 1 1 1 1 1 1 1 1 1 1 1 1 7 0 0 0 0 5 1 1 1 1 1 1 1 7 0 0 0 0
0 0 0 0 5 1 1 1 1 1 1 1 13 6 6 6 6 12 1 1 1 1 1 1 1 7 6 6 6 6 12 1 1 1 1 1 1 1 13 6 6 6 6 12 1 1 1 1 1 1 1 7 0 0 0 0 5 1 1 1 1 1 1 1 7 0 0 0 0
0 0 0 0 5 1 1 1 1 1 1 1 7 0 0 0 0 5 1 1 1 1 1 1 1 7 0 0 0 0 5 1 1 1 1 1 1 1 7 0 0 0 0 5 1 1 1 1 1 1 1 7 0 0 0 0 5 1 1 1 1 1 1 1 7 0 0 0 0
0 0 0 0 9 6 6 6 6 6 6 6 11 0 0 0 0 9 6 6 6 6 6 6 6 11 0 0 0 0 9 6 6 6 6 6 6 6 11 0 0 0 0 9 6 6 6 6 6 6 6 11 0 0 0 0 9 6 6 6 6 6 6 6 11 0 0 0 0
0 0 0 0 0 0 0 0 0 0 0 0 0 0 0 0 0 0 0 0 0 0 0 0 0 0 0 0 0 0 0 0 0 0 0 0 0 0 0 0 0 0 0 0 0 0 0 0 0 0 0 0 0 0 0 0 0 0 0 0 0 0 0 0 0 0 0 0 0
0 0 0 0 0 0 0 0 0 0 0 0 0 0 0 0 0 0 0 0 0 0 0 0 0 0 0 0 0 0 0 0 0 0 0 0 0 0 0 0 0 0 0 0 0 0 0 0 0 0 0 0 0 0 0 0 0 0 0 0 0 0 0 0 0 0 0 0 0
0 0 0 0 0 0 0 0 0 0 0 0 0 0 0 0 0 0 0 0 0 0 0 0 0 0 0 0 0 0 0 0 0 0 0 0 0 0 0 0 0 0 0 0 0 0 0 0 0 0 0 0 0 0 0 0 0 0 0 0 0 0 0 0 0 0 0 0 0
0 0 0 0 0 0 0 0 0 0 0 0 0 0 0 0 0 0 0 0 0 0 0 0 0 0 0 0 0 0 0 0 0 0 0 0 0 0 0 0 0 0 0 0 0 0 0 0 0 0 0 0 0 0 0 0 0 0 0 0 0 0 0 0 0 0 0 0 0


